GGGGGGGGGGGGGGGGGPPPPPPPGGGGGGGGGGGGGGGGG
GGGRRRPPPPPPPPPPPPPPPPPPPPPPPPPPPPPPPPPPP
GGGTTPPPPPPPPPPPTTPPPPPPPPPPPPPPPPPPPPPPP
GGGPPPPPPPPPPPPPPPPPPPPPPPPPPPPPPPPPPPPPP
GGGPPPPPPPPPPPPPPPPPPPPPPPPPPPPPPPPPPPPPP
GGGPPPPPPPPPPPPPPPPPPPPPPPPPPPPPPPPPPPPPP
GGGPPPPPPPPPPPPPPPPPPPPPPPPPPPPPPPPPPPPPP
PPPPPPPPPPPPPPPPPPPPPPPPPPPPPPPPPPPPPPPPP
PPPPPPPPPPPPPPPPPPPPPPPPPPPPPPPPPPPPPPPPP
PPPPPPPPPPPPPPPPPPPPPPPPPPPPPPPPPPPPPPPPP
GGGPPPPPPPPPPPPPPPPPPPPPPPPPPPPPPPPPPPPPP
GGGPPPPPPPPPPPPPPPPPPPPPPPPPPPPPPPPPPPPPP
GGGPPPPPPPPPPPPPPPPPPPPPPPPPPPPPPPPPPPPPP
GGGPPPPPPPPPPPPPPPPPPPPPPPPPPPPPPPPPPPPPP
GGGPPPPPPPPPPPPPPPPPPPPPPPPPPPPPPPPPPPPPP
GGGPPPPPPPPPPPPPPPPPPPPPPPPPPPPPPPPPPPPPP
GGGPPPPPPPPPPPPPPPPPPPPPPPPPPPPPPPPPPPPPP
GGGPPPPPPPPPPPPPPPPPPPPPPPPPPPPPPPPPPPPPP
GGGPPPPPPPPPPPPPPPPPPPPPPPPPPPPPPPPPPPPPP